aeropuerto
albergue
apartamentos|aptos
arboleda|arb
arrabal|arral
arroyo|arry
asuntos exteriores|aa ee
atlético|atlo|atletico
ayuntamiento
balneario|balnr
baños|banos
banco
bar
biblioteca|bibl
borda
café|cafe
cafetería|cafeteria
campo|cpo
cantera|cantr
cantina|canti
caserío|caserio|csrío|csrio
casa
casas
castillo|cast
cementerio
charcutería|charcuteria
clinica
club|clb
colegio
comisario de policía|comisario de policia
correos
corretaje
convento|cnvto
cooperativa|coop
cortijo|crtjo
dehesa|dhsa
de capital variable|de cv|de c v
diseminado|disem
embajada
escuela
escuelas
estación|estacion|estcn
estacionamiento|estto
fábrica|fabrica|fca|fbrca
farmacia
ferrocarril|fc|f.c.|f.c|f c
ferrocarriles|ff cc|ffcc
granja|granj
hacienda|hda
heladería|heladeria
hipódromo|hipodromo|hipod
horno
hospital|hosp
hostal
hotel
iglesia|igl|igla
iglesias|iglas
instituto|inst
librería|libreria
mercado|merc
mirador|mrdor
monasterio|mtrio
muebles
muelle|meull
pabellón|pabellon
palacio|palac
palacios|palacs
panadería|panaderia
parque|pque|parq|pq|pqe
pastelería|pasteleria
pescadería|pescaderia
pilar
playa
puebla|pbla
pueblo|pblo
puente|pnte
puerta|pta
puerto|pto
rancho|rch|rcho
restaurante
sanatorio|sanat
santuario|santu
sociedad|soc
taberna
taller
talleres
templo
tienda
torre
transito|trans
universidad|univ|uni|univers
villa