cobertizo|cbtiz
colonia|col
conjunto|cjto|conj|cto
cooperativa|coop
corral|crral
corralillo|crrlo
cortijo|crtjo
cuadra|cuadr
demarcacion|demar
departamento|dept|depto
derecha|dcha
diseminado|disem
entrada|entd|entr
escalera|esca
escaleras|escas
escalinata|escal|escalin
estancias|estanc|est
extension|ext
extramuros|extrm
extrarradio|extrr
interior|int
izquierda|izq|izda|izqa|izqda
jardin|jdin|jard
jardines|jdins|jards
mansion|mans
mansiones|manses
nucleo|ncleo
numero|#|num|no|numr|numro|nro|n.ro
officina|off
partida|ptda
poblado|pbdo|pob|pobl
poligono|polig
poligono residencial|polig res|pgres|pg res|pr|p.r.|p.r|p r
poligono industrial|polig ind|pgind|pg ind|pi|p.i.|p.i|p i
portal|prtal|prtl
portcio|prtco
portillo|ptilo|ptllo
puerta|pta
quebrada|qbda
residencial|resid|res
sector|sect
trasera|tras
vecindario|vecin