acceso|acces
alameda|alam
alqueria|alque
andador|andad
angosta|angta
apeadero|apdro
autopista|auto
autovia|autov
avenida|av|avd|avda
bajada|bjada
banda|bda
barranco|branc
barranquillo|bqllo
barriada|barda
barrio|bo
bloque|blque|bloq|blq
boulevard|blvd|bvd
brazal|brzal
bulevar|bulev|blev|blv|bv
calle|c|cl|cll|c /|ca
calleja|cllja
callejon|callej|cjon|cllon|cj
calle privada|calle priv|c priv|cl priv|cll priv|c / priv
callejuela|cjla
callizo|cllzo
calzada|czada|calz
camino|cno|cmo|cmno|cm
camino hondo|ch|c h
camino nuevo|cn|c n
camino viejo|cv|c v
caminito|cmt
camping|campg
cantera|cantr
canton|cant
carrera|cra|carra|carr
carretera|ctra|cr
carreterin|ctrin
carretil|crtil
carril|crril
cerrada|cda|cer
cinturon|cint
circuito|cto
circunvalacion|ccvcn
corredor|crrdo
costanilla|cstan
costera
cuesta|custa
diagonal|diag
diseminado|disem
espalda|eslda
estrada|estda
explanada|expla
extramuros|extrm
galeria|gale
glorieta|gta|g
gran via|gv|g v
hacienda|hda
ladera|ldera
laderas|lderas
llanura|llnra
malecon|malec
mirador|mrdor
muelle|meull
pantano|pant
paraje|praje
parque|pque|parq|pq|pqe
particular|parti
partida|ptda
pasadizo|pzo
pasaje|psaje|psj
paseo|po|pso|pseo|ps|p|p.o
paseo maritimo|psmar|ps mar
paso
pasillo|psllo
peatonal|peat
periferico|perif
plaza|pl|plza|pza|p za
plazoleta|pzta|plzta|plta
plazuela|plzla
poblado|pbdo
prazuela|przla
prolongacion|prol
puebla|pbla
pueblo|pblo
puente|pnte
rambla|rbla
rampla|rampa
retorno|ret|rt
ribera|bra
rincon|rcon|rin|rncn|rncon
rinconada|rcda|rcnda
ronda|rda
rotonda|rtda
rua
ruta|rta
sector|sect
sendera|sedra
sendero|send|sedro
subida|sbida
transito|trans
transversal|trval|trvsal
trasera|tras
travesia|trva|trvsia
vereda|vreda|ver
viaducto|vcto|vd
via|v
vista|vst|vsta|vist