accesso|acc.so|accso
autostrada|aut.da|autda
audostradale|aut.sle|autsle|aut sle|aut.ale|autale
autostrade|aut.de|autde
bretella|br.lla|brlla
bretelle|br.lle|brlle
calle|c.le|cle
campo|c.po|cpo
cavalcavia|cavalc.a|cavalca
chiusa|c.usa|cusa
circonvallazione|circonv.e|circonve
contrada|contr.a|contra
corso|c.so|cso
corte|c.te|cte
cortile|c.ile|ctile
ferrata|f.rata|frata
fondamenta|f.ta|fta
forca|f.ca|fca
forcella|forc.la|forcla
frazione|fraz.e|fraze
frazioni|fraz.i|frazi
galleria|gall.a|galla
gallerie|gall.e|galle
genna|g.na|gna
genne|g.ne|gne
largo|l.go|lgo
localita|loc|loc.ta|locta
piazza|p.za|p.zza|pza|pzza
piazzale|p.le|ple
piazzetta|p.ta|pta
ponte|p.te|pte
porta|p.ta|pta
provinciale
salizada|s.da|sda
stazione|staz
strada|s|str.a|stra
strada comunale|sc|s.c.|s.c|s c
strada provinciale|sp|s.p.|s.p|s p|str provinciale|s provinciale
strada regionale|sr|s.r.|s.r|s r
strada statale|ss|s.s.|s.s|s s
strada vicinale|sv|s.v.|s.v|s v
stretta|str.ta|strta
strette|str.te|strte
stretti|str.ti|strti
stretto|str.to|strto
superstrada
tangenziale
traversa
via|v
via comunale|vc|v.c.|v.c|v c
via provincale|vp|v.p.|v.p|v p|v provinciale
via statale|vs|v.s.|v.s|v s
viale|v.le|vle
vicolo|v.lo|vlo
vico