allee|a|al
autobahn
bach
bad
bahnhof|bhf|bf
boulevard|bd
brucke|bruecke|br
buhl|buehl
chaussee|ch
damm|d
forsthaus|fh
gasse|g
graben|gr
grosser
grosse|gr|g
grosses
heiligen
hof|h
kamp|k
kleine|kl
kleiner
kleines
obere|ob
oberer|ob
oberes
pfad
platz|pl
quelle|qu
rundwanderweg|rww
strasse|str
untere|u
unterer
unteres
weg|w