association
association sans but lucratif|asbl|a s b l
enterprise individuelle|ei|e i
enterprise unipersonnelle a responsabilite limitee|eurl|e u r l
fondation
fondation privee
fondation d'utilite publique
fond commun de placement|fcp|f c p
fonds de placement
group|gp
groupe|gpe
groupement|gpt
groups|gps
groupes|gpes
groupement d'interet economique|groupement dinteret economique|gie|g i e
raison individuelle|ri|r i
societe anonyme|sa|s a
societe anonyme libanaise|sal|s a l
societe anonyme omanaise generale|saog|s a o g
societe anonyme omanaise close|saoc|s a o c
societe cooperative|scoop|s coop
societe cooperative a responsabilite limitee|scrl|s c r l
societe cooperative a responsabilite illimitee|scri|s c r i
societe cooperative de production|scop|s c o p
societe d'economie mixte|societe d' economie mixte|societe deconomie mixte|sem|s e m
societe d'investissement a capital fixe|societe dinvestissement a capital fixe|societe d' investissement a capital fixe|sicaf|s i c a f
societe d'investissement a capital variable|societe dinvestissement a capital variable|societe d' investissement a capital variable|sicav|s i c a v
societe interne
societe momentanee
societe a responsabilite limitee|sarl|s a r l
societe en participation|sep|s e p
societe de fait
societe en nom colletif|snc|s n c
societe en commandite|sc|s c
societe en commandite simple|scs|s c s
societe en commandite par actions|sca|s c a
societe par actions simplifiee|sas|s a s
societe privee a responsabilite limitee|sprl|s p r l
societe privee a responsabilite limitee unipersonnelle|sprlu|s p r l u
societe simple|ss|s s