agosto|ago
altezza|alt.za|alt za|altza
altezze|alt.ze|alt ze|altze
antica|ant.a|ant a
antiche|ant.e|ant e
antichi|ant.i|ant i
antico|ant.o|ant o
aprile|apr
arcipelaghi|arcip.ghi|arcip ghi|arcipghi
arcipelagho|arcip.gho|arcip gho|arcipgho
badde|b.de|b de
bassa|b.sa|b sa|bsa
bassi|b.si|b si|bsi
basso|b.so|b so|bso
basse|b.se|b se|bse
bealera|b.ra|b ra|bra
bealere|b.re|b re|bre
calvario|calv.o|calv o
canale|can.le|can le
canali|can.li|can li
caverna|cav.na|cav na
caverne|cav.ne|cav ne
centrale|centr.e|centr e
colla|c.la
colle|c.le
colletta|c.tta|c tta
collina|cll.a|cll a
colline|cll.e|cll e
collo|c.llo
cozzi|c.zi|c zi|czi
cozzo|c.zo|c zo|czo
commerciale|comm.le
comunale|com.le
comunita|com.ta|com ta
decembre|dec
dicembre|dic
distretto|distr.o|distr o
diversivo|div.vo|div vo
fanteria|fant.a|fant a
febbraio|feb|fev
fontanile|font.ile|font ile
fonte|f.te|f te
fosso|f.so|f so|fso
fossa|f.sa|f sa|fsa
fratelli|flli|f lli
gennaio|gen
ghiacciai|gh.i|gh i
ghiacciaio|gh.io|gh io
giardino|g.no|g no
giardini|g.ni|g ni
giugno|giug
giulio|giul
gran|gr
grande|gr.de|gr de
grandi|gr.di|gr di
grossa|gr.sa|gr sa
grosse|gr.se|gr se
grossi|gr.si|gr si
grosso|gr.so|gr so
grotta|gr.ta|gr ta
gortte|gr.te|gr te
gruppi|gr.pi|gr pi
gruppo|gr.po|gr po
incoronata|incor.ta
industria|ind.ia|ind ia
industriale|ind.ale|ind ale
industriali|ind.ali|ind ali
inferiore|inf.e|inf e
inferiori|inf.i|inf i
internazionale|intern.le|intern le
internazionali|intern.li|intern li
interne|int.ne|int ne
interni|int.ni|int ni
interno|int.no|int no
laghetto|lag.to|lag to
lago|l
laguna|lag.a|lag a
lunghi|l.ghi|l ghi
lungo|l.go|l go
maggio|mag
maddalena|madd.na|madd na
madonna|mad.na|mad na
madonne|mad.ne|mad ne
maggiore|magg.re|magg re
maggiori|magg.ri|magg ri
mandamento|mand.to|mand to
mannu|m.nu|m nu
marinella|marin.la|marin la
marino|m.ino|m ino
marittimo|maritt.o|maritt o
marzo|mar
media|med.a
mediterraneo|medit.eo|medit eo
metropolitana|metr.na|metr na|metro
militare|mil.re|mil re
muri|m.ri|m ri
muro|m.ro|m ro
navigli|nav.i|nav i
naviglio|nav.o|nav o
nazionale|naz.le|naz le
nazionali|naz.li|naz li
nostra|n.ra|n ra
nostro|n.ro|n ro
novembre|nov
nuova|n.va|n va
nuove|n.ve|n ve
nuovi|n.vi|n vi
nuovo|n.vo|n vo
ottobre|ott
penisola|penis.a
piccola|p.cola|p cola
piccole|p.cole|p cole
piccoli|p.coli|p coli
piccolo|p.colo|p colo
settembre|set