acceso|acces
alameda|alam
alquería|alqueria|alque
ampliación|amp|amplicacion|ampl
andador|andad|and
angosta|angta
apeadero|apdro
autopista|auto|autop|aut|ap
autovía|autovia|autov
avenida|av|avd|avda|av /
avenida calle|ac|av cl|av| cll|av calle
avenida carrera|ak|av cr|av cra|avda cra|avda cr
bajada|bjada|bjd
banda|bda
barranco|branc
barranquillo|bqllo
barriada|barda
boulevard|blvd|bvd
brazal|brzal
bulevar|bulev|blev|blv|bv|bl|boulevard
calle|c|cl|cll|c /|ca|call|c.
calleja|cllja
callejón|callejon|callej|cjón|cjon|cllon|cllón|cj
calle privada|calle priv|c priv|c.priv|cl priv|cl.priv|cll priv|cll.priv|c / priv|cll / priv
callejuela|cjla
callizo|cllzo
calzada|czada|calz
camino|cno|cmo|cmno|cm|cam
camino hondo|ch|c.h.|c.h|c h
camino nuevo|cn|c.n.|c.n|c n
camino viejo|cv|c.v.|c.v|c v
caminito|cmt
camping|campg
cantera|cantr
cantón|canton|cant
carrera|cra|carra|carr|cr|kra|kr
carretera|ctra|cr|ct|carr
carreterín|carreterin|ctrin
carretil|crtil
carril|crril
cerrada|cda|cer
cinturón|cinturon|cint
circular|cq
circuito|cto
circunvalar|cv|crv|cirv
circunvalación|cvln|ccvcn|circun|circunvalacion
corredor|crrdo
costanilla|cstan
costera
crucero|cro
cuchilla|cuch
cuesta|custa
diagonal|diag|dg
diseminado|disem
espalda|eslda
estrada|estda
explanada|expla
extensión|ext|extension
extramuros|extrm
galería|galeria|gale
glorieta|gta|g
gran vía|gran via|gv|g v
hacienda|hda
jirón|jiron|jr
ladera|ldera
laderas|lderas
libramiento|lib
llanura|llnra
malecón|malecon|malec
mirador|mrdor
muelle|meull
pantano|pant
paraje|praje|prj
parque|pque|parq|pq|pqe
particular|parti
partida|ptda
pasadizo|pzo
pasaje|psaje|psj
paseo|pº|p°|po|pso|pseo|pas|ps|p|p.o|p.º|p.°
paseo maritimo|psmar|ps mar
paso
pasillo|psllo
peatonal|peat
periférico|perif|periferico
plaza|pl|plza|pza|p.za|pz|plz
plazoleta|pzta|plzta|plta
plazuela|plzla
poblado|pbdo
polígono residencial|poligono residencial|políg res|polig res|pol.res|pol res|pgres|pg res|pr|p.r.|p.r|p r
polígono industrial|poligono industrial|políg ind|polig ind|pol.ind|pol ind|pgind|pg ind|pi|p.i.|p.i|p i
prolongación|prolongacion|prol
puebla|pbla
pueblo|pbl|pblo|pbo
puente|pnte
ramal|rml
rambla|rbla
rampla|rampa|rpla
retorno|ret|rt
rincón|rincon|rcon|rin|rncn|rncon
rinconada|rcda|rcnda
ronda|rda
rotonda|rtda
ruta|rta
sector|sect
sendera|sedra
sendero|send|sedro
subida|sbida
tránsito|transito|trans
transversal|trval|trvsal|tv|tr
trasera|tras
travesía|travesia|trva|trvsía|trvsia
vereda|vreda|ver|vda
viaducto|vcto|vd|vdto
via|v
vista|vst|vsta|vist